NO ./textures/NO.xpm
C 250,30,0
SO ./textures/SO.xpm
EA ./textures/EA.xpm
WE ./textures/NO.xpm


F 220,100,0

        1111  1111111111111111111        
        11001111000110000000000001
        11011000001110000000001111
        1001000000000000N00001             
111111111011000001110000000001111
100000000011000001110111111111111
11111110111111111011100000000001
11111111101111111110111010100101
1111100011010101110000001000111
    1000000000011000000100001
11111000000000001101010010001
11000001110101011111011110001
11110111011101010101111010001
11111111111111111111111111111