
C 250,30,0
SO ./textures/SOcfgfgh.xpm
EA ./textures/EA.xpm
WE ./textures/WE.xpm
NO ./textures/NO.xpm







F 220,100,0

        111111111111111111111111                     
        100011100100000000000001                       
        101110000100000000000001                        
        100100000000000000000001                     
111111111011000001110000000000N1                   
10000000001100000111010101111111                       
11110111111111011100000010001          
11110111111111011101010010001
11000000110101011100000010001   
10000000000000001100000010001   
10000000000000001101010010001
11000001110101011111011110001
11010111 11101011101111010001
11111111 11111111111111111111
