EA ./textures/NO.xpm
WE ./textures/NO.xpm
SO ./textures/NO.xpm                           
NO ./textures/NO.xpm
   
F   220,255,255
C   240,100,24


        111111111111111111111111                     
        100011100100000000000001                       
        101110000100000000000001                        
        1001000000000000000N0001                      
11111111101100000111000000000001                      
10000000001100000111010101111111                       
11110111111111011100000010001          
11110111111111011101010010001
11000000110101011100000010001   
10000000000000001100000010001   
10000000000000001101010010001
11000001110101011111011110001
11010111 11101011101111010001
11111111 11111111111111111111

